NO ./assets/png/box.png
SO ./assets/png/floor.png
WE ./assets/png/exitclose.png
EA ./assets/png/wall.png

F 220,100,0
C 225,30,0

1111111111111111111111111
1000000000000000000000001
1111111111111100000000001
1000000000000000000000001
1111111111100000000000001
1000000000000000000000001
1111111100000000000000001
1000000000000000000000001
1111100000000000000000001
1000000000000000000000001
1110000000000000000000001
1000000000000000000000001
10000N0000000000000000001
1111111111111111111111111