NO ./assets/png/box.png
SO ./assets/png/floor.png
WE ./assets/png/exitclose.png
EA ./assets/png/wall.png

F 72,231,84
C 112,226,238

1111111111111111111111111
1N00000000000000000000001
1000000000000000000000001
1000000000000000000000001
1000000000000000000000001
1000000000000000000000001
1000000000000000000000001
1000000000000000000000001
1111111111111100000000001
1000000000000000000000001
1111111111100000000000001
1000000000000000000000001
1111111100000000000000001
1000000000000000000000001
1111100000000000000000001
1000000000000000000000001
1000000000000000000000001
1000000000000000000000001
1000000000000000000000001
1111111111111111111111111