NO ./assets/png/BIGBRICKS.png
SO ./assets/png/CASTLEBRICKS.png
WE ./assets/png/CLAYBRICKS.png
EA ./assets/png/DUNGEONBRICKS.png

F 220,100,0
C 225,30,0

1111111111111111111111
1000000100000000000001
1000000100000000000001
1000000D00000000000001
10000001000000000000W1
1000000100000000000001
1111111111D11111111111
1000000000000000000001
1000000000000000000001
1111111111111111111111
