NO ./assets/png/wall.png
SO ./assets/png/wall-torch.png
WE ./assets/png/wall-vines.png
EA ./assets/png/wall-broken.png

F 160,127,51
C 243,185,42

1111111111111111111111
1000000100000000000001
1000000100000000000001
1000000D00000000000001
10000001000000000000W1
1000000100000000000001
1111111111D11111111111
1000000000000000000001
1000000000000000000001
1111111111111111111111
