NO ./assets/png/wall.png
SO ./assets/png/wall-torch.png
WE ./assets/png/wall-vines.png
EA ./assets/png/wall-broken.png

F 220,100,0
C 225,30,0

        1111111111111111111
        1000000000110000001
        1011000001110000001
        1001000N00000000001
111111111011000001110000001
100000000011000001110111111
111101111111110111000000101
111101111111110111010100001
110000001101010111000000101
111111111111111111111111111
