NO ./assets/png/BIGBRICKS.png
SO ./assets/png/CASTLEBRICKS.png
WE ./assets/png/CLAYBRICKS.png
EA ./assets/png/DUNGEONBRICKS.png

F 220,100,0
C 225,30,0

1111111111111111111111
1000000000000000000001
1000000000B00000000001
1000000000000000000001
10000000A0W0C000000001
1000000000000000000001
1000011111111111100001
1000000000B00000000001
1000000000000000000001
1111111111111111111111